pel - wish, choose -> bau - subjunctive mood auxiliary

xendos - to be able -> ézó - potential mood auxiliary

kʼes - in addition, also, too -> ʃa - too, also, as well

tim - and -> di - and

miwda - house -> méi

ɣil - 1sg -> eu - 1sg

tʼeb - 1pl -> tou - 1pl

mej - 2sg -> mé - 2sg

jog - 2pl -> éi - 2pl

tek - 3sg -> de - 3sg

vu - 3pl -> u - 3pl

lim - person -> li - (A) Liran Person

rakal - tongue -> réu - language

sowan - -> sawäsó - king (*sowan + *-t'or)

sokowi - to like, to enjoy -> sayäwa, saywa - to love

mow - high, tall -> mó - augmentative

so - great, all -> sa - augmentative

mowso -> mós - superlative

jutʼira - to strike, stab -> ir - to have sex (General, Vulgar)

sʼekan - to defile -> sai - to have oral sex (Vulgar)

jadure - to thrust, attack -> izera - to have vaginal sex (Vulgar)

kʼotʼuŋ - -> kasu - to have anal sex (Vulgar)

sʼejxe - to suck -> si to perform oral sex on a penis (Vulgar)

betʼaj - to lick -> vasé - to perform oral sex on a vagina (Vulgar)

pelim - breast -> bali - breast, tit (Vulgar)

muruz - -> moru - A submissive person, especially within a relationship; A Bitch (Vulgar)

pʼitak - tip, edge -> pezə - penis (Vulgar)

reŋ - this -> ré - definite article

limros - people (collective) -> Liró - The Liran people

limrosfi - people (dative collective) -> Liré - The Liran language

kajnaɣ - to think, to arrange, to advise -> généré - Council

Générémós Liréi - Highest Liran Council, similar to a National Parliament

raj -> -ré - Verb to noun suffix. Denotes a place where an action occurs.
    e.g. to run + ré = run place -> racetrack

murno - -mun - Verb to noun suffix. Loosely creates resultative nouns from the given verbal root.
    e.g. to divide + -mun -> The result of dividing - political party, sect, etc.

zartʼow - to cut, divide, slice -> rétóré - party, faction, set

Rétómun Lizoréi - People's Party

tuzmitʼor -> dumesó - United (lit. "bound")

tʼor - Gerundive Suffix -> so - Non-productive equivalent to ker

mo - m(a) - of/relating to - Equivalent to -ic, -ish, -al

ker - -> jé - Verb to Noun Suffix - one who performs an action

los - Noun to Adjective Suffix

Sénólizu - Democracy

Sénósäwasó - Monarchy

Sénójé - President

Généjé - Councilor, Senator, Congressman, Representative, Advisor

naskor - nayó - middle, center

nayómajé - centrist

-majé (m(a) + jé) - Similar to -ist suffix; Literally means "someone who performs an action of or relating to (root)

mavraz - móur

vozna - un

nanlo - nal

sʼin - si

kʼunin - kĕnă

tetaz - de

lavaj - lau

likros - lĕiró

titama - to stand - dĕimă

fʼil - fĕu

dĕimeuléi

dĕimămajé

k'o - low

móur - river

neke - land -> néi

mavraznekekʼo -> Maunăjó (/mounəʒo/): Liran Country

(r)yː -> (r)ai - <r> is inserted if there is no consonant between yː and the root.

lownaj -> lénă - brother

moɣbus -> mévu - sister



